####################
#........##........#
#.##.###.##.###.##.#
#..................#
#.##.#.######.#.##.#
#....#...##...#....#
####.###.##.###.####
   #.#........#.#   
####.#.##  ##.#.####
#......##  ##......#
####.#.######.#.####
   #.#........#.#   
####.#.######.#.####
#........##........#
#.##.###.##.###.##.#
#..#.....P.....#..#
##.#.#.######.#.#.##
#....#...##...#....#
#.######.##.######.#
#..................#
####################
