########################
#......##......##......#
#.####.#.####.#.####.#.#
#.#  #.#.#  #.#.#  #.#.#
#.####.#.####.#.####.#.#
#..G...##..P..##...G..#
########################