####################
#........##........#
#.#P#.#.##.#.##.#.#
#.#  #.#.##.#.#  #.#
#.#G##.#.##.#.##.#.#
#..................#
####################